________________________________________
|--------------------------------------|
|--------------------------------------|
|--------------------------------------|
|--------------------------------------|
|---------------------------------O----|
|--------------------------------------|
|--------------------------------------|
|--------------------------------------|
|--------------**********--------------|
|--------------------------------------|
|--------------------------------------|
|------------------M-------------------|
|--------------------------------------|
|--------------------------------------|
|-----------*******--*******-----------|
|--------------------------------------|
|--------------------------------------|
|****--------------M---------------****|
|--------------------------------------|
|--------------------------------------|
|--------****-------***-----***--------|
|--------------------------------------|
|--------------------------------------|
|------------------M-------------------|
|--------------------------------------|
|--------------------------------------|
|----***--------***-----****----***----|
|--------------------------------------|
|--------------------------------------|
|--------------------------------------|
|--H-----------------------------------|
|--------------------------------------|
****************************************