________________________________________
|--------------------------------------|
|--------------------------------------|
|--------------------------------------|
|-------M------------------------------|
|--------------------------------------|
|--------------------------------------|
|--------------------------------------|
|--------------------------------------|
|--------------------------------------|
|---------------------------N----------|
|--------------------------------------|
****----************************----****
|--------------------------------------|
|--------------------------------------|
|--------------------------------------|
|--------------------------------------|
|--------L-----------------------------|
|--------------------------------------|
****----************************----****
|--------------------------------------|
|--------------------------------------|
|--------------------------------------|
|--------------------------------------|
|--------------------------------------|
|--------------------------------------|
****----************************----****
|--------------------------------------|
|--------------------------------------|
|]]]]]]]]]]]]]]]-----------------------|
|--------------]-----------------------|
|-H------------]-----------------------|
|--------------]-----------------------|
****************************************
